S---M-WW--W----
----W----------
--------W-W----
--------W-WW---
W----W-----M---
WWW-M--------WW
--W-----------M
-----W---------
----WWW--W----W
--W------------
---W----W------
--W-------W----
---------W-----
-W-M--W----WW-W
W--------------
