S---W---------W
----------WW---
-------W-------
-----W----W---W
-W-W-M--W---WW-
WW-W-----W-----
W--W-------WM--
--W-------M----
WM-------------
--W--------W---
-WWW-W-------WW
------------WM-
---------W-----
---W-W---------
-------W-W---W-
