S--W------M----
---W-M-W------W
WM---WW---W----
-----M----W----
--W------W-----
W---W--W--W----
---W-----------
-------------M-
--W-------W----
------W--------
------W------W-
-----W-W--W----
-W--W--W-W-----
W----W---W-WW--
-------------W-
